Afghanistan - Afghan
Africa - African
Albania - Albanian
Algeria - Algerian
America - American
Andorra - Andorran
Angola - Angolan
Antarctica - Antarctic
Antigua - Antiguan
Arab - Arabian
Argentina - Argentinean
Armenia - Armenian
Australia - Australian
Austria - Austrian
Bahamas - Bahamian
Bahrain - Bahraini
Bangladesh - Bangladeshi
Barbados - Barbadian
Belarus - Belo Russian
Belgium - Belgian
Belize - Belizean
Benin - Beninese
Bermuda - Bermudan
Bhutan - Bhutanese
Bolivia - Bolivian
Bosnia - Bosnian
Botswana - Botswanan
Brazil - Brazilian
Britain - British
Brunei - Bruneian
Bulgaria - Bulgarian
Burkina - Burkinese
Burma - Burmese
Burundi - Burundian
Cambodia - Cambodian
Cameroon - Cameroonian
Canada - Canadian
Canada - Canadian
Cape Verde - Cape Verdean
Ceorgia - Georgian
Chad - Chadian
Chile - Chilean
China - Chinese
Columbia - Columbian
Comoros - Comoran
Congo - Congolese
Costa Rica - Costa Rican
Croatia - Croatian
Cuba - Cuban
Cyprus - Cypriot
Denmark - Danish
Dominica - Dominican
Ecuador - Ecuadorian
Egypt - Egyptian
EI Salvador - El Salvadoreah
England - Englishman
England - English
Eritrea - Eritrean
Estonia - Estonian
Ethiopia - Ethiopian
Europe - European
Fiji - Fijian
Finland - Finnish
France - Frenchman
France - French
Gabon - Gabonese
Gambia - Gambian
Germany - German
Germany - Germanise
Ghana - Ghanaian
Greece - Greek
Grenada - Grenadian
Guatemala - Guatemalan
Guinea - Guinean
Guyana - Guyanese
Haiti - Haitian
Holland - Dutch
Honduras - Honduran
Hungary - Hungarian
Iceland - Icelandic
India - Indian
Indonesia - Indonesian
Iran - Iranian
Iraq - Iraqi
Ireland - Irishman
Israel - Israeli
Italy - Italian
Jamaica - Jamaican
Japan - Japanese
Jordan - Jordanian
Kazakhstan - Kazakh
Kazakhstan - Kazakhs
Kenya - Kenyan
Kirgyzstan - Kirgyz
Korea - Korean
Kuwait - Kuwaiti
Laos - Laotian
Latvia - Latvian
Lebanon - Lebanese
Liberia - Liberian
Libya - Libyan
Liechtenstein - Liechtensteiner
Lithuania - Lithuanian
Luxembour - Luxembourger
Madagascar - Madagascan
Malawi - Malawian
Malaysia - Malaysian
Maldives - Maldivian
Mali - Malian
Malta - Maltese
Mauritania - Mauritanian
Mauritius - Mauritian
Mexico - Mexican
Moldova - Moldovan
Monaco - Monacan
Mongolia - Mongolian
Morocco - Moroccan
Mozambique - Mozambiquean
Namibia - Namibian
Nepal - Nepalese
Netherlands - Dutch
New Zealand - New Zealander
Nicaragua - Nicaraguan
Nigeria - Nigerian
Norway - Norwegian
Oman - Omanian
Oman - Omanis
Pakistan - Pakistani
Palestine - Palestinian
Papua New Guinea - Papuan
Paraguay - Paraguayan
Pem - Peruvian
Peru - Peruvian
Philippines - Philippine
Poland - Pole
Portugal - Portuguese
Qatar - Qatari
Romania - Romanian
Russia - Russian
Rwanda - Rwandan
Samoa - Samoan
San Marino - San Marinese
Scotland - Scot
Senegal - Senegalese
Serbia - Serb
Seychelles - Seychellois
Sierra Leone - Sierra Leonean
Singapore - Singaporean
Slovakia - Slovak
Slovenia - Slovene
Somalia - Somali
South Africa - South African
Spain - Spanish
Sri Lanka - Sri Lanka
Sudan - Sudanese
Suriname - Surinamese
Sweden - Swedish
Switzerland - Swiss
Syria - Syrian
Taiwan - Taiwanese
Tajikistan - Tajik
Tanzania - Tanzanian
Thailand - Thai
Togo - Togolese
Trinidad - Trinidadian
Tunisia - Tunisian
Turkey - Turkish
Turkey - Turkish
Turkmenistan - Turkmen
Tuvalu - Tuvaluan
Uganda - Ugandan
Ukraine - Ukrainian
Uruguay - Uruguayan
Venezuela - Venezuelan
Vietnam - Vietnamese
Yemen Republic - Yemeni
Yugoslavia - Yugoslavian
Zambia - Zambian
Zimbabwe - Zimbabwean
